xxxxxxxxxxxxxx
x            x
x            x
x            x
4      3     x
x            x
x            x
x            x
x            x
x      2     1
x            x
x            x
xxxxxxxxxxxxxx

